/workspaces/Sonoteca-Busqueda/sonoteca/BABIES GROUCH Boy 12 months Short.wav	BABIES GROUCH Boy 12 months Short	
/workspaces/Sonoteca-Busqueda/sonoteca/BABIES TALK Boy 12 months Awoowoo.wav	BABIES TALK Boy 12 months Awoowoo	
/workspaces/Sonoteca-Busqueda/sonoteca/BABIES TALK Boy 12 months Wogwa.wav	BABIES TALK Boy 12 months Wogwa	
/workspaces/Sonoteca-Busqueda/sonoteca/BABIES TALK Boy 12 months Iyaa.wav	BABIES TALK Boy 12 months Iyaa	
/workspaces/Sonoteca-Busqueda/sonoteca/BABIES WHINE Boy 3 months Gurgling.wav	BABIES WHINE Boy 3 months Gurgling	
/workspaces/Sonoteca-Busqueda/sonoteca/BABIES SCREAM Boy 3 months Unconstanst Throat 01.wav	BABIES SCREAM Boy 3 months Unconstanst Throat 01	
/workspaces/Sonoteca-Busqueda/sonoteca/BABIES LAUGH Boy 12 months Mama Short.wav	BABIES LAUGH Boy 12 months Mama Short	
/workspaces/Sonoteca-Busqueda/sonoteca/BABIES DREAM Boy 3 months High Short.wav	BABIES DREAM Boy 3 months High Short	
/workspaces/Sonoteca-Busqueda/sonoteca/BABIES TALK Boy 12 months How Do.wav	BABIES TALK Boy 12 months How Do	
/workspaces/Sonoteca-Busqueda/sonoteca/BABIES CRY Boy 3 months Coughing.wav	BABIES CRY Boy 3 months Coughing	
/workspaces/Sonoteca-Busqueda/sonoteca/BABIES WEEP Boy 3 months.wav	BABIES WEEP Boy 3 months	
/workspaces/Sonoteca-Busqueda/sonoteca/BABIES LAUGH Boy 12 months Giggeling Dynamic.wav	BABIES LAUGH Boy 12 months Giggeling Dynamic	
/workspaces/Sonoteca-Busqueda/sonoteca/BABIES TALK Boy 12 months Uhhwaa.wav	BABIES TALK Boy 12 months Uhhwaa	
/workspaces/Sonoteca-Busqueda/sonoteca/BABIES GROUCH Boy 12 months Impatient 01.wav	BABIES GROUCH Boy 12 months Impatient 01	
/workspaces/Sonoteca-Busqueda/sonoteca/BABIES DREAM Boy 3 months Close.wav	BABIES DREAM Boy 3 months Close	
/workspaces/Sonoteca-Busqueda/sonoteca/BABIES WEEP 3 months Upset Boy.wav	BABIES WEEP 3 months Upset Boy	
/workspaces/Sonoteca-Busqueda/sonoteca/BABIES LAUGH Boy 12 months Moving Clothes.wav	BABIES LAUGH Boy 12 months Moving Clothes	
/workspaces/Sonoteca-Busqueda/sonoteca/BABIES SHOUT Girl 12 months High and Long 02.wav	BABIES SHOUT Girl 12 months High and Long 02	
/workspaces/Sonoteca-Busqueda/sonoteca/BABIES TALK Boy 12 months Growl.wav	BABIES TALK Boy 12 months Growl	
/workspaces/Sonoteca-Busqueda/sonoteca/BABIES LAUGH Boy 12 months Screaming Loud Short.wav	BABIES LAUGH Boy 12 months Screaming Loud Short	
/workspaces/Sonoteca-Busqueda/sonoteca/BABIES GROUCH Boy 12 months Impatient 02.wav	BABIES GROUCH Boy 12 months Impatient 02	
/workspaces/Sonoteca-Busqueda/sonoteca/BABIES WEEP Boy 3 months Heavy Increase.wav	BABIES WEEP Boy 3 months Heavy Increase	
/workspaces/Sonoteca-Busqueda/sonoteca/BABIES LAUGH Boy 12 months.wav	BABIES LAUGH Boy 12 months	
/workspaces/Sonoteca-Busqueda/sonoteca/BABIES TALK Boy 12 months Bera Nana.wav	BABIES TALK Boy 12 months Bera Nana	
/workspaces/Sonoteca-Busqueda/sonoteca/BABIES CRY Boy 3 months Increase Decrease.wav	BABIES CRY Boy 3 months Increase Decrease	
/workspaces/Sonoteca-Busqueda/sonoteca/BABIES LAUGH Boy 12 months Stutter.wav	BABIES LAUGH Boy 12 months Stutter	
/workspaces/Sonoteca-Busqueda/sonoteca/BABIES TALK Boy 12 months Nahemnahem.wav	BABIES TALK Boy 12 months Nahemnahem	
/workspaces/Sonoteca-Busqueda/sonoteca/BABIES SCREAM Boy 12 months Very Short.wav	BABIES SCREAM Boy 12 months Very Short	
/workspaces/Sonoteca-Busqueda/sonoteca/BABIES TALK Boy 12 months Wowwow.wav	BABIES TALK Boy 12 months Wowwow	
/workspaces/Sonoteca-Busqueda/sonoteca/BABIES TALK Boy 12 months Berka.wav	BABIES TALK Boy 12 months Berka	
/workspaces/Sonoteca-Busqueda/sonoteca/BABIES TALK Boy 3 months Iyeadah.wav	BABIES TALK Boy 3 months Iyeadah	
/workspaces/Sonoteca-Busqueda/sonoteca/BABIES WHINE Boy 3 months Long.wav	BABIES WHINE Boy 3 months Long	
/workspaces/Sonoteca-Busqueda/sonoteca/BABIES LAUGH Boy 12 months Short 08.wav	BABIES LAUGH Boy 12 months Short 08	
/workspaces/Sonoteca-Busqueda/sonoteca/BABIES TALK Boy 12 months Baba 01.wav	BABIES TALK Boy 12 months Baba 01	
/workspaces/Sonoteca-Busqueda/sonoteca/BABIES TALK Boy 12 months Huuhh.wav	BABIES TALK Boy 12 months Huuhh	
/workspaces/Sonoteca-Busqueda/sonoteca/BABIES TALK Boy 12 months Baby.wav	BABIES TALK Boy 12 months Baby	
/workspaces/Sonoteca-Busqueda/sonoteca/BABIES TALK Boy 12 months Ho Ba Bey.wav	BABIES TALK Boy 12 months Ho Ba Bey	
/workspaces/Sonoteca-Busqueda/sonoteca/BABIES COUGH Girl 12 months 01.wav	BABIES COUGH Girl 12 months 01	
/workspaces/Sonoteca-Busqueda/sonoteca/BABIES TALK Boy 12 months Oh Houa.wav	BABIES TALK Boy 12 months Oh Houa	
/workspaces/Sonoteca-Busqueda/sonoteca/BABIES LAUGH Boy 12 months Short 07.wav	BABIES LAUGH Boy 12 months Short 07	
/workspaces/Sonoteca-Busqueda/sonoteca/BABIES TALK Boy 3 months Bebe.wav	BABIES TALK Boy 3 months Bebe	
/workspaces/Sonoteca-Busqueda/sonoteca/BABIES LAUGH Boy 3 months Short 01.wav	BABIES LAUGH Boy 3 months Short 01	
/workspaces/Sonoteca-Busqueda/sonoteca/BABIES DREAM Boy 3 months Spittle.wav	BABIES DREAM Boy 3 months Spittle	
/workspaces/Sonoteca-Busqueda/sonoteca/BABIES SHOUT Girl 12 months High and Long 01.wav	BABIES SHOUT Girl 12 months High and Long 01	
/workspaces/Sonoteca-Busqueda/sonoteca/BABIES YAWN Boy 3 months.wav	BABIES YAWN Boy 3 months	
/workspaces/Sonoteca-Busqueda/sonoteca/BABIES LAUGH Girl 24 months Giggling Moving Close 01.wav	BABIES LAUGH Girl 24 months Giggling Moving Close 01	
/workspaces/Sonoteca-Busqueda/sonoteca/BABIES CRY Boy 3 months Sustained.wav	BABIES CRY Boy 3 months Sustained	
/workspaces/Sonoteca-Busqueda/sonoteca/BABIES TALK Boy 12 months Amguhguh.wav	BABIES TALK Boy 12 months Amguhguh	
/workspaces/Sonoteca-Busqueda/sonoteca/BABIES SCREAM Boy 3 months Heavy 02.wav	BABIES SCREAM Boy 3 months Heavy 02	
/workspaces/Sonoteca-Busqueda/sonoteca/BABIES TALK Boy 12 months Abluhh.wav	BABIES TALK Boy 12 months Abluhh	
/workspaces/Sonoteca-Busqueda/sonoteca/BABIES SHOUT Girl 12 months Mid.wav	BABIES SHOUT Girl 12 months Mid	
/workspaces/Sonoteca-Busqueda/sonoteca/BABIES WEEP Girl 24 months Tired 01.wav	BABIES WEEP Girl 24 months Tired 01	
/workspaces/Sonoteca-Busqueda/sonoteca/BABIES CRY Girl 24 months Fade In.wav	BABIES CRY Girl 24 months Fade In	
/workspaces/Sonoteca-Busqueda/sonoteca/BABIES LAUGH Boy 12 months Screaming Amused.wav	BABIES LAUGH Boy 12 months Screaming Amused	
/workspaces/Sonoteca-Busqueda/sonoteca/BABIES TALK Boy 12 months Donkey Like 03.wav	BABIES TALK Boy 12 months Donkey Like 03	
/workspaces/Sonoteca-Busqueda/sonoteca/BABIES TALK Boy 12 months Oh.wav	BABIES TALK Boy 12 months Oh	
/workspaces/Sonoteca-Busqueda/sonoteca/BABIES WEEP Girl 24 months Tired 02.wav	BABIES WEEP Girl 24 months Tired 02	
/workspaces/Sonoteca-Busqueda/sonoteca/BABIES TALK Boy 3 months Daddy 01.wav	BABIES TALK Boy 3 months Daddy 01	
/workspaces/Sonoteca-Busqueda/sonoteca/BABIES WHINE Boy 3 months Reedy.wav	BABIES WHINE Boy 3 months Reedy	
/workspaces/Sonoteca-Busqueda/sonoteca/BABIES TALK Boy 12 months Iiiii.wav	BABIES TALK Boy 12 months Iiiii	
/workspaces/Sonoteca-Busqueda/sonoteca/BABIES TALK Girl 12 months Bahaha.wav	BABIES TALK Girl 12 months Bahaha	
/workspaces/Sonoteca-Busqueda/sonoteca/BABIES TALK Boy 12 months Baba 02.wav	BABIES TALK Boy 12 months Baba 02	
/workspaces/Sonoteca-Busqueda/sonoteca/BABIES LAUGH Boy 3 months Short 03.wav	BABIES LAUGH Boy 3 months Short 03	
/workspaces/Sonoteca-Busqueda/sonoteca/BABIES BABBLE Boy 3 months Stressed.wav	BABIES BABBLE Boy 3 months Stressed	
/workspaces/Sonoteca-Busqueda/sonoteca/BABIES TALK Boy 12 months Ha.wav	BABIES TALK Boy 12 months Ha	
/workspaces/Sonoteca-Busqueda/sonoteca/BABIES BURP Boy 3 months.wav	BABIES BURP Boy 3 months	
/workspaces/Sonoteca-Busqueda/sonoteca/BABIES TALK Boy 12 months Bahbee.wav	BABIES TALK Boy 12 months Bahbee	
/workspaces/Sonoteca-Busqueda/sonoteca/BABIES TALK Boy 3 months Iyahyeyyay.wav	BABIES TALK Boy 3 months Iyahyeyyay	
/workspaces/Sonoteca-Busqueda/sonoteca/BABIES LAUGH Boy 12 months Sudden End.wav	BABIES LAUGH Boy 12 months Sudden End	
/workspaces/Sonoteca-Busqueda/sonoteca/BABIES CRY Girl 24 months High.wav	BABIES CRY Girl 24 months High	
/workspaces/Sonoteca-Busqueda/sonoteca/BABIES LAUGH Boy 12 months Short 06.wav	BABIES LAUGH Boy 12 months Short 06	
/workspaces/Sonoteca-Busqueda/sonoteca/BABIES SCREAM Boy 3 months High.wav	BABIES SCREAM Boy 3 months High	
/workspaces/Sonoteca-Busqueda/sonoteca/BABIES TALK Boy 12 months Babeeeeehhhh.wav	BABIES TALK Boy 12 months Babeeeeehhhh	
/workspaces/Sonoteca-Busqueda/sonoteca/BABIES TALK Boy 12 months Mama Nana Pitch.wav	BABIES TALK Boy 12 months Mama Nana Pitch	
/workspaces/Sonoteca-Busqueda/sonoteca/BABIES TALK Boy 12 months Mama 03.wav	BABIES TALK Boy 12 months Mama 03	
/workspaces/Sonoteca-Busqueda/sonoteca/BABIES LAUGH Boy 12 months Amused.wav	BABIES LAUGH Boy 12 months Amused	
/workspaces/Sonoteca-Busqueda/sonoteca/BABIES TALK Boy 12 months Baba Dada.wav	BABIES TALK Boy 12 months Baba Dada	
/workspaces/Sonoteca-Busqueda/sonoteca/BABIES COUGH Girl 12 months 02.wav	BABIES COUGH Girl 12 months 02	
/workspaces/Sonoteca-Busqueda/sonoteca/BABIES SCREAM Boy 3 months Decrease.wav	BABIES SCREAM Boy 3 months Decrease	
/workspaces/Sonoteca-Busqueda/sonoteca/BABIES LAUGH Girl 12 months Short.wav	BABIES LAUGH Girl 12 months Short	
/workspaces/Sonoteca-Busqueda/sonoteca/BABIES LAUGH Boy 3 months Short 02.wav	BABIES LAUGH Boy 3 months Short 02	
/workspaces/Sonoteca-Busqueda/sonoteca/BABIES TALK Boy 12 months Mhhhhh.wav	BABIES TALK Boy 12 months Mhhhhh	
/workspaces/Sonoteca-Busqueda/sonoteca/BABIES LAUGH Boy 12 months Dynamic.wav	BABIES LAUGH Boy 12 months Dynamic	
/workspaces/Sonoteca-Busqueda/sonoteca/BABIES SCREAM Boy 3 months Dynamic.wav	BABIES SCREAM Boy 3 months Dynamic	
/workspaces/Sonoteca-Busqueda/sonoteca/BABIES TALK Boy 12 months Baba 03.wav	BABIES TALK Boy 12 months Baba 03	
/workspaces/Sonoteca-Busqueda/sonoteca/BABIES TALK Boy 12 months Baba 05.wav	BABIES TALK Boy 12 months Baba 05	
/workspaces/Sonoteca-Busqueda/sonoteca/BABIES TALK Girl 12 months Hagabutte.wav	BABIES TALK Girl 12 months Hagabutte	
/workspaces/Sonoteca-Busqueda/sonoteca/BABIES LAUGH Boy 12 months Moving Clothes Mama 01.wav	BABIES LAUGH Boy 12 months Moving Clothes Mama 01	
/workspaces/Sonoteca-Busqueda/sonoteca/BABIES SHOUT Girl 12 months Yadadadada.wav	BABIES SHOUT Girl 12 months Yadadadada	
/workspaces/Sonoteca-Busqueda/sonoteca/BABIES TALK Boy 12 months Am Mama.wav	BABIES TALK Boy 12 months Am Mama	
/workspaces/Sonoteca-Busqueda/sonoteca/BABIES LAUGH Boy 12 months Short 02.wav	BABIES LAUGH Boy 12 months Short 02	
/workspaces/Sonoteca-Busqueda/sonoteca/BABIES LAUGH Boy 12 months Giggeling Loud.wav	BABIES LAUGH Boy 12 months Giggeling Loud	
/workspaces/Sonoteca-Busqueda/sonoteca/BABIES WEEP Girl 24 months Short Fast.wav	BABIES WEEP Girl 24 months Short Fast	
/workspaces/Sonoteca-Busqueda/sonoteca/BABIES CRY Girl 24 months Heavy 02.wav	BABIES CRY Girl 24 months Heavy 02	
/workspaces/Sonoteca-Busqueda/sonoteca/BABIES WHINE Boy 3 months Uncomfortable.wav	BABIES WHINE Boy 3 months Uncomfortable	
/workspaces/Sonoteca-Busqueda/sonoteca/BABIES DREAM Boy 3 months Exhale.wav	BABIES DREAM Boy 3 months Exhale	
/workspaces/Sonoteca-Busqueda/sonoteca/BABIES SCREAM Boy 3 months Increasing.wav	BABIES SCREAM Boy 3 months Increasing	
/workspaces/Sonoteca-Busqueda/sonoteca/BABIES LAUGH Boy 12 months Very Short.wav	BABIES LAUGH Boy 12 months Very Short	
/workspaces/Sonoteca-Busqueda/sonoteca/BABIES LAUGH Boy 12 months Hehehe.wav	BABIES LAUGH Boy 12 months Hehehe	
/workspaces/Sonoteca-Busqueda/sonoteca/BABIES TALK Boy 12 months Mama 01.wav	BABIES TALK Boy 12 months Mama 01	
/workspaces/Sonoteca-Busqueda/sonoteca/BABIES LAUGH Boy 12 months Short 04.wav	BABIES LAUGH Boy 12 months Short 04	
/workspaces/Sonoteca-Busqueda/sonoteca/BABIES LAUGH Boy 12 months Short 03.wav	BABIES LAUGH Boy 12 months Short 03	
/workspaces/Sonoteca-Busqueda/sonoteca/BABIES TALK Boy 12 months Hee Ahh.wav	BABIES TALK Boy 12 months Hee Ahh	
/workspaces/Sonoteca-Busqueda/sonoteca/BABIES TALK Boy 12 months Mumble Wuhwuh.wav	BABIES TALK Boy 12 months Mumble Wuhwuh	
/workspaces/Sonoteca-Busqueda/sonoteca/BABIES TALK Boy 12 months Mama 04.wav	BABIES TALK Boy 12 months Mama 04	
/workspaces/Sonoteca-Busqueda/sonoteca/BABIES TALK Boy 12 months Mama Sad.wav	BABIES TALK Boy 12 months Mama Sad	
/workspaces/Sonoteca-Busqueda/sonoteca/BABIES CRY Boy 3 months Dynamic.wav	BABIES CRY Boy 3 months Dynamic	
/workspaces/Sonoteca-Busqueda/sonoteca/BABIES WEEP Girl 24 months.wav	BABIES WEEP Girl 24 months	
/workspaces/Sonoteca-Busqueda/sonoteca/BABIES TALK Boy 12 months Neyaneeya.wav	BABIES TALK Boy 12 months Neyaneeya	
/workspaces/Sonoteca-Busqueda/sonoteca/BABIES TALK Boy 12 months Uluhla Loud.wav	BABIES TALK Boy 12 months Uluhla Loud	
/workspaces/Sonoteca-Busqueda/sonoteca/BABIES TALK Boy 12 months Awlayleah.wav	BABIES TALK Boy 12 months Awlayleah	
/workspaces/Sonoteca-Busqueda/sonoteca/BABIES TALK Boy 12 months Arrwooohh.wav	BABIES TALK Boy 12 months Arrwooohh	
/workspaces/Sonoteca-Busqueda/sonoteca/BABIES DREAM Boy 3 months Random.wav	BABIES DREAM Boy 3 months Random	
/workspaces/Sonoteca-Busqueda/sonoteca/BABIES TALK Boy 12 months Ya.wav	BABIES TALK Boy 12 months Ya	
/workspaces/Sonoteca-Busqueda/sonoteca/BABIES SHOUT Girl 12 months Short.wav	BABIES SHOUT Girl 12 months Short	
/workspaces/Sonoteca-Busqueda/sonoteca/BABIES LAUGH Girl 24 months Giggling Moving Close 02.wav	BABIES LAUGH Girl 24 months Giggling Moving Close 02	
/workspaces/Sonoteca-Busqueda/sonoteca/BABIES TALK Girl 12 months Dada.wav	BABIES TALK Girl 12 months Dada	
/workspaces/Sonoteca-Busqueda/sonoteca/BABIES TALK Boy 12 months Buhbee.wav	BABIES TALK Boy 12 months Buhbee	
/workspaces/Sonoteca-Busqueda/sonoteca/BABIES TALK Boy 12 months Humbumbum.wav	BABIES TALK Boy 12 months Humbumbum	
/workspaces/Sonoteca-Busqueda/sonoteca/BABIES TALK Boy 3 months Daddy 02.wav	BABIES TALK Boy 3 months Daddy 02	
/workspaces/Sonoteca-Busqueda/sonoteca/BABIES TALK Boy 12 months Mhhneww.wav	BABIES TALK Boy 12 months Mhhneww	
/workspaces/Sonoteca-Busqueda/sonoteca/BABIES CRY Girl 24 months Heavy Long.wav	BABIES CRY Girl 24 months Heavy Long	
/workspaces/Sonoteca-Busqueda/sonoteca/BABIES GROUCH Girl 12 months Distressed.wav	BABIES GROUCH Girl 12 months Distressed	
/workspaces/Sonoteca-Busqueda/sonoteca/BABIES LAUGH Boy 12 months Heavy Short.wav	BABIES LAUGH Boy 12 months Heavy Short	
/workspaces/Sonoteca-Busqueda/sonoteca/BABIES TALK Boy 12 months Donkey Like 01.wav	BABIES TALK Boy 12 months Donkey Like 01	
/workspaces/Sonoteca-Busqueda/sonoteca/BABIES GROUCH Boy 12 months.wav	BABIES GROUCH Boy 12 months	
/workspaces/Sonoteca-Busqueda/sonoteca/BABIES COUGH Boy 12 months Two Times Short.wav	BABIES COUGH Boy 12 months Two Times Short	
/workspaces/Sonoteca-Busqueda/sonoteca/BABIES LAUGH Boy 12 months Scream.wav	BABIES LAUGH Boy 12 months Scream	
/workspaces/Sonoteca-Busqueda/sonoteca/BABIES TALK Boy 12 months Uhhwuhh.wav	BABIES TALK Boy 12 months Uhhwuhh	
/workspaces/Sonoteca-Busqueda/sonoteca/BABIES SHOUT Girl 12 months Very High to Low.wav	BABIES SHOUT Girl 12 months Very High to Low	
/workspaces/Sonoteca-Busqueda/sonoteca/BABIES SCREAM Boy 3 months Heavy 01.wav	BABIES SCREAM Boy 3 months Heavy 01	
/workspaces/Sonoteca-Busqueda/sonoteca/BABIES TALK Boy 12 months Huh.wav	BABIES TALK Boy 12 months Huh	
/workspaces/Sonoteca-Busqueda/sonoteca/BABIES SCREAM Boy 3 months Fast.wav	BABIES SCREAM Boy 3 months Fast	
/workspaces/Sonoteca-Busqueda/sonoteca/BABIES LAUGH Boy 12 months Short 05.wav	BABIES LAUGH Boy 12 months Short 05	
/workspaces/Sonoteca-Busqueda/sonoteca/BABIES CRY Girl 24 months Short.wav	BABIES CRY Girl 24 months Short	
/workspaces/Sonoteca-Busqueda/sonoteca/BABIES TALK Boy 12 months Donkey Like 02.wav	BABIES TALK Boy 12 months Donkey Like 02	
/workspaces/Sonoteca-Busqueda/sonoteca/BABIES WHINE Boy 3 months Unsettling.wav	BABIES WHINE Boy 3 months Unsettling	
/workspaces/Sonoteca-Busqueda/sonoteca/BABIES TALK Boy 3 months Iii Reverberant.wav	BABIES TALK Boy 3 months Iii Reverberant	
/workspaces/Sonoteca-Busqueda/sonoteca/BABIES LAUGH Boy 12 months Moving Clothes Mama 02.wav	BABIES LAUGH Boy 12 months Moving Clothes Mama 02	
/workspaces/Sonoteca-Busqueda/sonoteca/BABIES TALK Boy 12 months Mama 02.wav	BABIES TALK Boy 12 months Mama 02	
/workspaces/Sonoteca-Busqueda/sonoteca/BABIES LAUGH Girl 24 months High Reverberant.wav	BABIES LAUGH Girl 24 months High Reverberant	
/workspaces/Sonoteca-Busqueda/sonoteca/BABIES SHOUT Girl 12 months High Dynamic.wav	BABIES SHOUT Girl 12 months High Dynamic	
/workspaces/Sonoteca-Busqueda/sonoteca/BABIES BABBLE Girl 12 months Spittle.wav	BABIES BABBLE Girl 12 months Spittle	
/workspaces/Sonoteca-Busqueda/sonoteca/BABIES BABBLE Boy 3 months Mumble.wav	BABIES BABBLE Boy 3 months Mumble	
/workspaces/Sonoteca-Busqueda/sonoteca/BABIES TALK Boy 12 months Bera.wav	BABIES TALK Boy 12 months Bera	
/workspaces/Sonoteca-Busqueda/sonoteca/BABIES TALK Boy 12 months Babey Bebe.wav	BABIES TALK Boy 12 months Babey Bebe	
/workspaces/Sonoteca-Busqueda/sonoteca/BABIES CRY Boy 3 months Uncomfortable.wav	BABIES CRY Boy 3 months Uncomfortable	
/workspaces/Sonoteca-Busqueda/sonoteca/BABIES TALK Boy 12 months Baba 04.wav	BABIES TALK Boy 12 months Baba 04	
/workspaces/Sonoteca-Busqueda/sonoteca/BABIES SCREAM Boy 3 months Unconstanst Throat 02.wav	BABIES SCREAM Boy 3 months Unconstanst Throat 02	
/workspaces/Sonoteca-Busqueda/sonoteca/BABIES TALK Boy 12 months Pitch Up Mommeyy.wav	BABIES TALK Boy 12 months Pitch Up Mommeyy	
/workspaces/Sonoteca-Busqueda/sonoteca/BABIES CRY Girl 24 months Heavy 01.wav	BABIES CRY Girl 24 months Heavy 01	
/workspaces/Sonoteca-Busqueda/sonoteca/BABIES LAUGH Boy 12 months Short 01.wav	BABIES LAUGH Boy 12 months Short 01	
/workspaces/Sonoteca-Busqueda/.venv/lib/python3.12/site-packages/gradio/test_data/test_audio.wav	test audio	
/workspaces/Sonoteca-Busqueda/.venv/lib/python3.12/site-packages/scipy/io/tests/data/test-44100Hz-le-1ch-4bytes-early-eof.wav	test 44100Hz le 1ch 4bytes early eof	
/workspaces/Sonoteca-Busqueda/.venv/lib/python3.12/site-packages/scipy/io/tests/data/test-44100Hz-le-1ch-4bytes-incomplete-chunk.wav	test 44100Hz le 1ch 4bytes incomplete chunk	
/workspaces/Sonoteca-Busqueda/.venv/lib/python3.12/site-packages/scipy/io/tests/data/test-8000Hz-le-5ch-9S-5bit.wav	test 8000Hz le 5ch 9S 5bit	
/workspaces/Sonoteca-Busqueda/.venv/lib/python3.12/site-packages/scipy/io/tests/data/test-8000Hz-le-2ch-1byteu.wav	test 8000Hz le 2ch 1byteu	
/workspaces/Sonoteca-Busqueda/.venv/lib/python3.12/site-packages/scipy/io/tests/data/test-8000Hz-le-1ch-1byte-ulaw.wav	test 8000Hz le 1ch 1byte ulaw	
/workspaces/Sonoteca-Busqueda/.venv/lib/python3.12/site-packages/scipy/io/tests/data/test-8000Hz-le-3ch-5S-24bit-inconsistent.wav	test 8000Hz le 3ch 5S 24bit inconsistent	
/workspaces/Sonoteca-Busqueda/.venv/lib/python3.12/site-packages/scipy/io/tests/data/test-44100Hz-2ch-32bit-float-be.wav	test 44100Hz 2ch 32bit float be	
/workspaces/Sonoteca-Busqueda/.venv/lib/python3.12/site-packages/scipy/io/tests/data/test-8000Hz-le-3ch-5S-64bit.wav	test 8000Hz le 3ch 5S 64bit	
/workspaces/Sonoteca-Busqueda/.venv/lib/python3.12/site-packages/scipy/io/tests/data/test-8000Hz-le-3ch-5S-36bit.wav	test 8000Hz le 3ch 5S 36bit	
/workspaces/Sonoteca-Busqueda/.venv/lib/python3.12/site-packages/scipy/io/tests/data/test-8000Hz-le-3ch-5S-45bit.wav	test 8000Hz le 3ch 5S 45bit	
/workspaces/Sonoteca-Busqueda/.venv/lib/python3.12/site-packages/scipy/io/tests/data/test-8000Hz-be-3ch-5S-24bit.wav	test 8000Hz be 3ch 5S 24bit	
/workspaces/Sonoteca-Busqueda/.venv/lib/python3.12/site-packages/scipy/io/tests/data/test-8000Hz-le-3ch-5S-53bit.wav	test 8000Hz le 3ch 5S 53bit	
/workspaces/Sonoteca-Busqueda/.venv/lib/python3.12/site-packages/scipy/io/tests/data/test-8000Hz-le-4ch-9S-12bit.wav	test 8000Hz le 4ch 9S 12bit	
/workspaces/Sonoteca-Busqueda/.venv/lib/python3.12/site-packages/scipy/io/tests/data/test-8000Hz-le-3ch-5S-24bit.wav	test 8000Hz le 3ch 5S 24bit	
/workspaces/Sonoteca-Busqueda/.venv/lib/python3.12/site-packages/scipy/io/tests/data/test-44100Hz-le-1ch-4bytes.wav	test 44100Hz le 1ch 4bytes	
/workspaces/Sonoteca-Busqueda/.venv/lib/python3.12/site-packages/scipy/io/tests/data/test-44100Hz-2ch-32bit-float-le.wav	test 44100Hz 2ch 32bit float le	
/workspaces/Sonoteca-Busqueda/.venv/lib/python3.12/site-packages/scipy/io/tests/data/test-8000Hz-le-1ch-10S-20bit-extra.wav	test 8000Hz le 1ch 10S 20bit extra	
/workspaces/Sonoteca-Busqueda/.venv/lib/python3.12/site-packages/scipy/io/tests/data/test-44100Hz-be-1ch-4bytes.wav	test 44100Hz be 1ch 4bytes	
/workspaces/Sonoteca-Busqueda/.venv/lib/python3.12/site-packages/scipy/io/tests/data/test-44100Hz-le-1ch-4bytes-early-eof-no-data.wav	test 44100Hz le 1ch 4bytes early eof no data	
/workspaces/Sonoteca-Busqueda/.venv/lib/python3.12/site-packages/scipy/io/tests/data/test-48000Hz-2ch-64bit-float-le-wavex.wav	test 48000Hz 2ch 64bit float le wavex	
